Fund Code,Fund Name,Asset Code,Asset Name,IssuerId,Shares Outstanding,SOD Position,Transactions,EOD Position,EOD Percentage of Holdings
AX003,ABC Soverign Wealth Fund,AAAU,Perth Mint Physical Gold ETF,191176,21150900,580454,7189,587643,2.78%
AX003,ABC Soverign Wealth Fund,AADR,Advisorshares Dorsey Wright ADR,190299,13657329,740770,34522,775292,5.68%
AX003,ABC Soverign Wealth Fund,AAMC,Altisource Asset,259939,6379610,718825,62145,780970,12.24%
AX003,ABC Soverign Wealth Fund,AAU,Almaden Minerals,417842,15472303,313416,19289,332705,2.15%
AX003,ABC Soverign Wealth Fund,ACES,Alps Clean Energy ETF,325984,14882213,345030,29245,374275,2.51%
AX003,ABC Soverign Wealth Fund,ACIM,ACWI IMI MSCI ETF SPDR,379181,28144402,223964,-8093,215871,0.77%
AX003,ABC Soverign Wealth Fund,ACIO,Aptus Collared Income Opportunity ETF,192058,29120162,213183,50942,264125,0.91%
AX003,ABC Soverign Wealth Fund,ACSG,Xtrackers MSCI ACWI Ex USA ESG Leaders,300197,9101072,672424,56898,729322,8.01%
AX003,ABC Soverign Wealth Fund,ACSI,American Customer Satisfaction Core,152153,20704995,782449,64821,847270,4.09%
AX003,ABC Soverign Wealth Fund,ACU,Acme United Corp,205776,13071018,780412,-8791,771621,5.90%
AX003,ABC Soverign Wealth Fund,ACWF,Global Multifactor Ishares Edge MSCI ETF,449423,23333380,425483,5521,431004,1.85%
AX003,ABC Soverign Wealth Fund,ACWV,Global Min Vol Ishares Edge MSCI ETF,435537,20610747,84977,29,85006,0.41%
AX003,ABC Soverign Wealth Fund,ACY,Aerocentury Corp,320237,18665084,627703,21746,649449,3.48%
AX003,ABC Soverign Wealth Fund,AE,Adams Resources & Energy,317647,16875502,293875,52977,346852,2.06%
AX003,ABC Soverign Wealth Fund,AEF,Aberdeen EM Equity Income Fund Inc,179710,24315663,683348,8569,691917,2.85%
AX003,ABC Soverign Wealth Fund,AFIF,Anfield Universal Fixed Income ETF,393815,18798521,757782,23861,781643,4.16%
AX003,ABC Soverign Wealth Fund,AFK,Africa Index ETF Vaneck,355109,2869124,175606,28750,204356,7.12%
AX003,ABC Soverign Wealth Fund,AFTY,CSOP FTSE China A50 ETF,205065,26030948,437945,15535,453480,1.74%
AX003,ABC Soverign Wealth Fund,AGE,Agex Therapeutics Inc,457705,11015510,291520,46958,338478,3.07%
AX003,ABC Soverign Wealth Fund,AGG,US Aggregate Bond Ishares Core ETF,377992,3188350,493696,34217,527913,16.56%
AX003,ABC Soverign Wealth Fund,AGGE,IQ Enhanced Core Bond U.S. ETF,276307,4860567,81306,86938,168244,3.46%
AX003,ABC Soverign Wealth Fund,AGGP,IQ Enhanced Core Plus Bond U.S.,158489,26566289,335505,49076,384581,1.45%
AX003,ABC Soverign Wealth Fund,AGGY,Wisdomtree Yield Enhcd US Agg Bond Fund,242824,8411862,844558,41896,886454,10.54%
AX003,ABC Soverign Wealth Fund,AGQ,Ultra Silver Proshares,434243,5728329,281606,73542,355148,6.20%
AX003,ABC Soverign Wealth Fund,AGT,Argentina Ishares MSCI ETF,170417,24700862,452744,88834,541578,2.19%
AX003,ABC Soverign Wealth Fund,AGZ,Agency Bond Ishares ETF,333619,28719687,897809,45935,943744,3.29%
AX003,ABC Soverign Wealth Fund,AIEQ,Ai Powered Equity ETF,181760,10279456,36598,89967,126565,1.23%
AX003,ABC Soverign Wealth Fund,AIIQ,Ai Powered International Equity ETF,105700,24208399,185029,51144,236173,0.98%
AX003,ABC Soverign Wealth Fund,AINC,Ashford Inc,387397,26095820,896190,33284,929474,3.56%
WS202,XYZ Insurance Fund,AIRI,Air Industries Group Inc,399968,26322951,781495,44421,825916,3.14%
WS202,XYZ Insurance Fund,AKG,Asanko Gold Inc,489328,19420844,611336,23746,635082,3.27%
WS202,XYZ Insurance Fund,ALFA,Alphaclone Alternative Alpha ETF,258172,27188616,222880,44435,267315,0.98%
WS202,XYZ Insurance Fund,ALO,Alio Gold Corp,269159,10642837,274835,8392,283227,2.66%
WS202,XYZ Insurance Fund,ALTS,Mstar Alternative Solutions Proshares,233184,17841401,852008,5132,857140,4.80%
WS202,XYZ Insurance Fund,AMBO,Ambow Education Holding Ltd,145354,22314607,368661,31735,400396,1.79%
WS202,XYZ Insurance Fund,AMJ,Alerian MLP Index ETN JP Morgan,316509,29935052,252762,68207,320969,1.07%
WS202,XYZ Insurance Fund,AMJL,X-Links Mthy Pay 2X Leveraged Alerian,150244,3610070,298155,59395,357550,9.90%
WS202,XYZ Insurance Fund,AMLP,Alps Alerian MLP ETF,153286,1270470,305645,88096,393741,30.99%
WS202,XYZ Insurance Fund,AMOM,Qraft Ai-Enhanced U.S. Large Cap,430953,569073,277254,25684,302938,53.23%
WS202,XYZ Insurance Fund,AMPE,Ampio Pharmaceuticals,450084,1705883,578108,50096,628204,36.83%
WS202,XYZ Insurance Fund,AMS,American Shared Hospital Services,417056,24131521,105703,8739,114442,0.47%
WS202,XYZ Insurance Fund,AMU,Etracs Alerian MLP Index ETN,213001,4685241,333699,78007,411706,8.79%
WS202,XYZ Insurance Fund,AMUB,Etracs Alerian MLP ETN Series B,462746,7521273,287280,89607,376887,5.01%
WS202,XYZ Insurance Fund,AMZA,Infracap MLP ETF,446334,12143849,765555,59529,825084,6.79%
WS202,XYZ Insurance Fund,ANGL,Fallen Angel HY Bond ETF Vaneck,375984,6822481,240240,30933,271173,3.97%
WS202,XYZ Insurance Fund,AOA,Aggressive Allocation Ishares Core ETF,324885,26475221,884629,84360,968989,3.66%
WS202,XYZ Insurance Fund,AOIL,Aberdeen Standard Bloomberg WTI Crude,270982,14549075,191609,-5075,186534,1.28%
WS202,XYZ Insurance Fund,AOK,Conservative Allocation Ishares Core ETF,285791,8173002,663775,67582,731357,8.95%
WS202,XYZ Insurance Fund,AOM,Moderate Allocation Ishares Core ETF,204081,24708209,522560,79013,601573,2.43%
WS202,XYZ Insurance Fund,AOR,Growth Allocation Ishares Core ETF,293422,27848155,821437,52355,873792,3.14%
SC101,Harvee School Fund,APT,Alpha Pro Tech,398611,14312317,695833,88784,784617,5.48%
SC101,Harvee School Fund,ARCM,Arrow Reserve Capital Management ETF,353293,18398713,632836,43768,676604,3.68%
SC101,Harvee School Fund,ARGT,G-X FTSE Argentina 20 ETF,225749,18894981,533714,35027,568741,3.01%
SC101,Harvee School Fund,ARKF,Ark Fintech Innovation ETF,398198,24170405,244019,81998,326017,1.35%
SC101,Harvee School Fund,ARKG,Ark Genomic Revolution Multi-Sector ETF,371561,8852626,303422,-414,303008,3.42%
SC101,Harvee School Fund,ARKK,Ark Innovation ETF,255860,29494971,573854,11830,585684,1.99%
SC101,Harvee School Fund,ARKQ,Ark Industrial Innovation ETF,301072,19516734,120941,-6681,114260,0.59%
SC101,Harvee School Fund,ARKW,Ark Web X.0 ETF,172441,11679856,894727,76326,971053,8.31%
SC101,Harvee School Fund,ARMP,Armata Pharmaceuticals Inc,339011,21185761,805120,56855,861975,4.07%
SC101,Harvee School Fund,ARN.P,Arconic Inc Pf 3.75,378549,8297362,367057,31012,398069,4.80%
SC101,Harvee School Fund,ASEA,G-X FTSE Asean 40 ETF,448156,13976077,603623,62354,665977,4.77%
SC101,Harvee School Fund,ASHR,Db-Xt Harvest CSI 300 China A,317805,8760840,141966,79634,221600,2.53%
SC101,Harvee School Fund,ASHS,Db-Xt Harvest CSI 500 China A,352585,8704216,847243,6591,853834,9.81%
SC101,Harvee School Fund,ASHX,Db-Xt CSI 300 China A Hgd Eq,248579,3334550,309484,47854,357338,10.72%
SC101,Harvee School Fund,ASM,Avino Silver & Gold,284852,15132228,473719,40738,514457,3.40%
SC101,Harvee School Fund,ATMP,Barclays Plus Select MLP ETN,254220,12262853,850694,25330,876024,7.14%
SC101,Harvee School Fund,ATNM,Actinium Pharmaceuticals Inc,196179,14895548,652729,59296,712025,4.78%
WD202,Emerging Market Fund,AUG,Auryn Resources Inc,314712,7426893,372998,47048,420046,5.66%
WD202,Emerging Market Fund,AUMN,Golden Minerals CO,338042,24375054,108470,67966,176436,0.72%
WD202,Emerging Market Fund,AUSF,Global X Adaptive US Factor ETF,269906,13569418,880093,81001,961094,7.08%
WD202,Emerging Market Fund,AWTM,Aware Ultra-Short Duration Enhanced,442960,22629602,272267,80821,353088,1.56%
WD202,Emerging Market Fund,AWX,Avalon Holdings Corp,322428,4537393,406931,35485,442416,9.75%
WD202,Emerging Market Fund,AXJL,Asia Pacific Ex-Japan Wisdomtree,145822,12561663,552347,89200,641547,5.11%
WD202,Emerging Market Fund,AXJV,Asia Ex Japan Min Vol Ishares Edge MSCI,378352,16883873,285141,87459,372600,2.21%
WD202,Emerging Market Fund,AXU,Alexco Resource Corp,250817,25962954,888091,20042,908133,3.50%
QS909,US Equity Fund,AAAU,Perth Mint Physical Gold ETF,191176,21150900,388370,62739,451109,2.13%
QS909,US Equity Fund,AADR,Advisorshares Dorsey Wright ADR,190299,13657329,61518,29791,91309,0.67%
QS909,US Equity Fund,AAMC,Altisource Asset,259939,6379610,154129,58392,212521,3.33%
QS909,US Equity Fund,AAU,Almaden Minerals,417842,15472303,570753,-5210,565543,3.66%
QS909,US Equity Fund,ACES,Alps Clean Energy ETF,325984,14882213,555161,34139,589300,3.96%
QS909,US Equity Fund,ACIM,ACWI IMI MSCI ETF SPDR,379181,28144402,227621,78478,306099,1.09%
QS909,US Equity Fund,ACIO,Aptus Collared Income Opportunity ETF,192058,29120162,523079,-8815,514264,1.77%
QS909,US Equity Fund,ACSG,Xtrackers MSCI ACWI Ex USA ESG Leaders,300197,9101072,497789,16628,514417,5.65%
QS909,US Equity Fund,ACSI,American Customer Satisfaction Core,152153,20704995,491372,59350,550722,2.66%
QS909,US Equity Fund,ACU,Acme United Corp,205776,13071018,130893,65190,196083,1.50%
QS909,US Equity Fund,ACWF,Global Multifactor Ishares Edge MSCI ETF,449423,23333380,818670,48237,866907,3.72%
QS909,US Equity Fund,ACWV,Global Min Vol Ishares Edge MSCI ETF,435537,20610747,515338,21512,536850,2.60%
QS909,US Equity Fund,ACY,Aerocentury Corp,320237,18665084,216298,16797,233095,1.25%
QS909,US Equity Fund,AE,Adams Resources & Energy,317647,16875502,881021,-5708,875313,5.19%
QS909,US Equity Fund,AEF,Aberdeen EM Equity Income Fund Inc,179710,24315663,734191,73882,808073,3.32%
QS909,US Equity Fund,AFIF,Anfield Universal Fixed Income ETF,393815,18798521,359326,75067,434393,2.31%
IS504,IXIX Insurance Fund,AIRI,Air Industries Group Inc,399968,26322951,696612,34942,731554,2.78%
IS504,IXIX Insurance Fund,AKG,Asanko Gold Inc,489328,19420844,85479,-3065,82414,0.42%
IS504,IXIX Insurance Fund,ALFA,Alphaclone Alternative Alpha ETF,258172,27188616,14144,56238,70382,0.26%
IS504,IXIX Insurance Fund,ALO,Alio Gold Corp,269159,10642837,151858,56957,208815,1.96%
IS504,IXIX Insurance Fund,ALTS,Mstar Alternative Solutions Proshares,233184,17841401,32002,70596,102598,0.58%
IS504,IXIX Insurance Fund,AMBO,Ambow Education Holding Ltd,145354,22314607,662810,35215,698025,3.13%
IS504,IXIX Insurance Fund,AMJ,Alerian MLP Index ETN JP Morgan,316509,29935052,290999,26721,317720,1.06%
IS504,IXIX Insurance Fund,AMJL,X-Links Mthy Pay 2X Leveraged Alerian,150244,3610070,780364,53318,833682,23.09%
IS504,IXIX Insurance Fund,AMLP,Alps Alerian MLP ETF,153286,1270470,122763,-7386,115377,9.08%
IS504,IXIX Insurance Fund,AMOM,Qraft Ai-Enhanced U.S. Large Cap,430953,569073,239109,61002,300111,52.74%
SC506,OXO School Fund,APT,Alpha Pro Tech,398611,14312317,521622,85700,607322,4.24%
SC506,OXO School Fund,ARCM,Arrow Reserve Capital Management ETF,353293,18398713,464232,69661,533893,2.90%
SC506,OXO School Fund,ARGT,G-X FTSE Argentina 20 ETF,225749,18894981,267741,46028,313769,1.66%
SC506,OXO School Fund,ARKF,Ark Fintech Innovation ETF,398198,24170405,336402,46581,382983,1.58%
SC506,OXO School Fund,ARKG,Ark Genomic Revolution Multi-Sector ETF,371561,8852626,891274,28136,919410,10.39%
SC506,OXO School Fund,ARKK,Ark Innovation ETF,255860,29494971,15464,4486,19950,0.07%
SC506,OXO School Fund,ARKQ,Ark Industrial Innovation ETF,301072,19516734,605486,72867,678353,3.48%
SC506,OXO School Fund,ARKW,Ark Web X.0 ETF,172441,11679856,43022,-2460,40562,0.35%
SC506,OXO School Fund,ARMP,Armata Pharmaceuticals Inc,339011,21185761,521941,72775,594716,2.81%
SC506,OXO School Fund,ARN.P,Arconic Inc Pf 3.75,378549,8297362,157764,6338,164102,1.98%
SC506,OXO School Fund,ASEA,G-X FTSE Asean 40 ETF,448156,13976077,516262,40772,557034,3.99%
BX790,China Equity Fund,AAAU,Perth Mint Physical Gold ETF,191176,21150900,870800,49306,920106,4.35%
BX790,China Equity Fund,AADR,Advisorshares Dorsey Wright ADR,190299,13657329,558059,76868,634927,4.65%
BX790,China Equity Fund,AAMC,Altisource Asset,259939,6379610,63889,25556,89445,1.40%
BX790,China Equity Fund,AAU,Almaden Minerals,417842,15472303,783255,39822,823077,5.32%
BX790,China Equity Fund,ACES,Alps Clean Energy ETF,325984,14882213,641277,16821,658098,4.42%
BX790,China Equity Fund,ACIM,ACWI IMI MSCI ETF SPDR,379181,28144402,607480,-5049,602431,2.14%
BX790,China Equity Fund,ACIO,Aptus Collared Income Opportunity ETF,192058,29120162,771566,11946,783512,2.69%
BX790,China Equity Fund,ACSG,Xtrackers MSCI ACWI Ex USA ESG Leaders,300197,9101072,667530,7612,675142,7.42%
BX790,China Equity Fund,ACSI,American Customer Satisfaction Core,152153,20704995,321620,38189,359809,1.74%
BX790,China Equity Fund,ACU,Acme United Corp,205776,13071018,95548,-3773,91775,0.70%
BX790,China Equity Fund,ACWF,Global Multifactor Ishares Edge MSCI ETF,449423,23333380,422903,18875,441778,1.89%
BX790,China Equity Fund,ACWV,Global Min Vol Ishares Edge MSCI ETF,435537,20610747,105776,72797,178573,0.87%
BX790,China Equity Fund,ACY,Aerocentury Corp,320237,18665084,185472,57781,243253,1.30%
BX790,China Equity Fund,AE,Adams Resources & Energy,317647,16875502,355005,53601,408606,2.42%
BX790,China Equity Fund,AEF,Aberdeen EM Equity Income Fund Inc,179710,24315663,196865,27410,224275,0.92%
BX790,China Equity Fund,AFIF,Anfield Universal Fixed Income ETF,393815,18798521,686755,79166,765921,4.07%
BX790,China Equity Fund,AFK,Africa Index ETF Vaneck,355109,2869124,205943,85611,291554,10.16%
BX790,China Equity Fund,AFTY,CSOP FTSE China A50 ETF,205065,26030948,53856,52457,106313,0.41%
BX790,China Equity Fund,AGE,Agex Therapeutics Inc,457705,11015510,209086,24069,233155,2.12%
BX790,China Equity Fund,AGG,US Aggregate Bond Ishares Core ETF,377992,3188350,157349,58911,216260,6.78%
BX790,China Equity Fund,AGGE,IQ Enhanced Core Bond U.S. ETF,276307,4860567,879750,54216,933966,19.22%
BX790,China Equity Fund,AGGP,IQ Enhanced Core Plus Bond U.S.,158489,26566289,86941,33391,120332,0.45%
BX790,China Equity Fund,AGGY,Wisdomtree Yield Enhcd US Agg Bond Fund,242824,8411862,617632,6422,624054,7.42%
AX404,DEF Private Wealth Fund,AAAU,Perth Mint Physical Gold ETF,191176,21150900,501250,25540,526790,2.49%
AX404,DEF Private Wealth Fund,AADR,Advisorshares Dorsey Wright ADR,190299,13657329,244252,7830,252082,1.85%
AX404,DEF Private Wealth Fund,AAMC,Altisource Asset,259939,6379610,159113,4107,163220,2.56%
AX404,DEF Private Wealth Fund,AAU,Almaden Minerals,417842,15472303,887513,31289,918802,5.94%
AX404,DEF Private Wealth Fund,ACES,Alps Clean Energy ETF,325984,14882213,393462,18573,412035,2.77%
AX404,DEF Private Wealth Fund,ACIM,ACWI IMI MSCI ETF SPDR,379181,28144402,373012,30205,403217,1.43%
AX404,DEF Private Wealth Fund,ACIO,Aptus Collared Income Opportunity ETF,192058,29120162,847409,64584,911993,3.13%
AX404,DEF Private Wealth Fund,ACSG,Xtrackers MSCI ACWI Ex USA ESG Leaders,300197,9101072,130153,75208,205361,2.26%
AX404,DEF Private Wealth Fund,ACSI,American Customer Satisfaction Core,152153,20704995,429050,87434,516484,2.49%
AX404,DEF Private Wealth Fund,ACU,Acme United Corp,205776,13071018,419942,86334,506276,3.87%
AX404,DEF Private Wealth Fund,ACWF,Global Multifactor Ishares Edge MSCI ETF,449423,23333380,181235,49281,230516,0.99%
AX404,DEF Private Wealth Fund,ACWV,Global Min Vol Ishares Edge MSCI ETF,435537,20610747,88076,-2012,86064,0.42%
AX404,DEF Private Wealth Fund,ACY,Aerocentury Corp,320237,18665084,25968,33516,59484,0.32%
AX404,DEF Private Wealth Fund,AE,Adams Resources & Energy,317647,16875502,195659,79463,275122,1.63%
AX404,DEF Private Wealth Fund,AEF,Aberdeen EM Equity Income Fund Inc,179710,24315663,341143,53882,395025,1.62%
AX404,DEF Private Wealth Fund,AFIF,Anfield Universal Fixed Income ETF,393815,18798521,676018,-31,675987,3.60%
AX404,DEF Private Wealth Fund,AFK,Africa Index ETF Vaneck,355109,2869124,672689,26831,699520,24.38%
